%%%%%%%%%%%
%         %
%         %
%         %
%         %
%         %
%         %
%         %
%         %
%%%%%%%%%%%